hard දැඩි 
race තරගය 
core මැද 
indirect වක්‍ර
grain ධාන්‍ය 
specially විශේෂයෙන්
exotic විදේශීය
residents දිසාපතිවරුන්
start ආරම්භය
aggregate එකතුව
transformation පරිවර්තනය
lessons පාඩම් 
lake වැව
distance දුර
arrival පැමිණීම
restructuring ප්‍රතිව්‍යුහගතකරණය 
tables වගු
accommodation ඉඩකඩ
measuring මැනීම 
applying ඉල්ලුම 
guest අමුත්තා
covers ආවරණ
secure සුරක්ෂිත
leather සම්
ways ක්‍රම
reservations සීමාවන් 
dues යෝග්‍ය
visa වීසා
omissions ප්‍රමාද
alliance සන්ධානය
tractors ට්‍රැක්ටර්
sand වැලි
metre මීටර්
cutting කැපීම
mechanical යාන්ත්‍රික
assisted සනාථ
boundary සීමාව
marine මුහුදු
spare අතිරේක
cause හේතුව
observers නිරීක්ෂකයන්
elements අවයව 
agro කෘෂි
conflict ගැටුම
plantations වැවිලි
standing තත්වය
controlled පාලිත
heading සිරස්තලය 
entertainment සංග්‍රහය 
look බලනවා
micro කුඩා
maintains පවත්වනවා
explanation විස්තරය
deficiency අඩුපාඩු 
shops කඩ
sewerage ජලාපවාහන
violation උල්ලංඝනය  
failed අසාර්ථක
absolute සම්පූර්ණ
examined විභාගය
modernization නවීකරණය 
serial මාලාව
inspections පරීක්ෂණ 
quantities ප්‍රමාණ
protecting ආරක්ෂක
semi අර්ධ 
tree තුරු
executive විධායක
measurements මිනුම්
assignment පැවරුමක්
portfolio ආයෝජන
bonus පාරිතෝෂිකය
variations වෙනස්කම් 
underground භූගත
halls ශාලා
output ප්‍රතිදානය
petitions පෙත්සම්
segment කොටස
geographical භූගෝලීය
procurements ප්‍රසම්පාදන
wood දැව
summaries සාරාංශ
football පාපන්දු
otherwise නැතහොත්
broadcast විකාශනය
easy පහසු 
mines පතල්
remuneration ගාස්තුව
disability ආබාධිත 
therein එහි
raised උද්ගත
search සෙවීම 
borrowings ණය
jurisdiction අධිකරණය
deed කාර්යය
audio ශ්‍රවණ
origin ආරම්භය
measure මැනීම
masters හිමියන්
songs ගීත
models ආකෘති
themselves ඔවුන්ම   
pumping පොම්ප 
expenditures වැය
proceeds උත්පාදන
strictly දැඩි
raised උද්ගත
organisations ආයතන
sir මහතා
seen දැකීම   
steel වානේ
optimal ප්‍රශස්ත   
aspirations අපේක්ෂා
cubic ඝනක
contractual ගිවිසුම්ගත
macro විශාල
concessional පිළිගැනීම
expertise විශේෂඥතාව
considerable ප්‍රමාණවත්
supervising අධීක්ෂණ  
trends ප්‍රවණතා
ensured සුරක්ෂිත 
hub කේන්ද්‍රස්ථානය
seats ආසන
clinic සායනය
pensioners විශ්‍රාමිකයන්
donors දායකයන්
bungalows බංගලා 
flora ශාක 
scales තල
islamic ඉස්ලාමීය
path මාර්ගය
gradually ක්‍රමානුකූල
convenience පහසුකම
voting ඡන්ද
increments වර්ධක
figure රූපය
campaign ව්‍යාපාරය
literature පොත්පත්
lead ප්‍රධාන 
gram ග්‍රෑම්
integral අඛණ්ඩ
vegetable ශාක
host සමූහය   
thirty තිහ
trees ගස් 
paragraphs ඡේද
hydro ජල
frame රාමුව
revising ප්‍රතිශෝධන
constantly නිතර
regularly ක්‍රමයෙන්
conducive සංවර්ධක
geodetic භූමිතික
majority බහුතරයක්
releasing මුදාහැරීම
kingdom රාජධානිය
capable දක්ෂ
excesses අතිරික්ත 
celebrations සැමරුම්
mandate නියෝගයක්
experienced ප්‍රවීණ
career වෘත්තිය   
complexes ආයතන
adult වැඩිහිටි
extending දික්කිරීම
feed පෝෂණය   
shelter ආවරණය 
till දක්වා
today අද
contributor දායකයා   
freedom නිදහස
answers පිළිතුරු 
theoretical අවිනිශ්චිත
nationally ජාතික
clay මැටි
modules මොඩියුල
dividends ලාභාංශ
trustees භාරකාර
immovable නිශ්චල   
forecast පුරෝකථනය
favorable සතුටුදායක
trafficking හුවමාරුව
lenses කාච
visual දෘශ්‍ය
labor ශ්‍රමය
becoming උචිත
libraries පුස්තකාල
girls බාලිකා
slow මන්දගාමී
seasons මෝසම්
aviation ආකාශතරණය
suit කට්ටලය
tour චාරිකාව
tours චාරිකා
compile සම්පාදන
sacred ශුද්ධ
collective සාමූහික
nonconventional සාම්ප්රදායිකනොවූ
branches ශාඛා
liquor මත්පැන්
dangerous අන්තරායකර
portion කොටස
marriages විවාහයන්
intermediate අතරමැදි
index දර්ශකය
exploration ගවේෂණය
underlying පෙනෙන
lost නෂ්ට
protected ආරක්ෂිත
systematically ක්‍රමානුකූලව
requesting අභියාචනය
twenty විසි
offenses වැරදි
count සංඛ්‍යාව
grass තෘණ   
advancement උන්නතිය  
thereto ඊට   
claim අයිතිය 
crime අපරාධ
hero වීරයා
bridge පාලම
indigenous දේශීය
chairmanship සභාපතිත්වය
finding තීරණය 
necessities අවශ්‍යතාවයන්
corrected සංශෝධිත
retirements විශ්‍රාම 
consent අනුමැතිය
twice දෙවරක්
fundamental මුලික
operative ක්‍රියාත්මක
ancient ආදි
cabs කැබ්
implements මෙවලම්   
shopping සාප්පු 
skill කුසලතාව
utmost උපරිම
earth පෘථිවිය
cars කාර් 
cooperatives සමුපකාර
thank ස්තූතිය
laboratories විද්‍යාගාර
missions මෙහෙයුම්
conciliation සාම
ships නැව්
focal කේන්ද්‍රීය
unique පරම
fire ගිනි
assumptions උපකල්පනයන්
warrant බලපත්‍රය
decline ක්ෂය
leader නායක
bakery පෝරණුව
partition කොටස
mother මව්
suggestions යෝජනා
cancellation කැපීම
broad පැහැදිලි
analyst විශ්ලේෂක   
fault වැරැද්ද
alcohol මත්පැන්
births ප්‍රභවයන්
judgments තීන්දු
completely සම්පූර්ණයෙන්
discipline විනය
fruits පලතුරු
almost සම්පූර්ණයෙන් 
films චිත්‍රපට
elephants අලි  
renewal ප්‍රතිසංස්කරණය
leaving යාම
judiciary අධිකරණය
nutritional පෝෂණ
coir කොහු
gathering එකතුව  
variances විචලනයන්
placing ආරෝපණය
clearance නිෂ්කාශනය
realistic තාත්වික
complaint චෝදනාව 
admission ප්‍රවේශ 
stream ඇළ
mega මහා
track පථය
famous ප්‍රසිද්ධ 
ayurvedic	ආයුර්වේද
preparations	සැකසුම්
checking	පරීක්ෂාව
charging	ආරෝපණය 
occupants	පදිංචිකරුවන්
confidence	විශ්වාසය
gradual	ක්‍රමානුකූල
cadres	පිරිස
concepts	සංකල්ප
overhead	ඉහළ
artificial	කෘත්‍රිම
solve	විසඳීම
campaigns	ව්‍යාපාර
equipments	උපකරණ
logistics	සම්පාදනය
showroom	ප්‍රදර්ශනාගාරය
farms	ගොවිපළ
repeated	පුනරාවර්තන
betterment	යහපැවැත්ම
admin	පාලක
providers	සැපයුම්කරුවන්
determination	අධිෂ්ඨානය
fauna	සතුන්
movements	ව්‍යාපාර
nondestructive	නිර්විනාශක
frauds	වංචා
consist	අඩංගු
assembly	රැස්වීම
categorization	වර්ගීකරණය
returns	ඒම
currencies	මුදල්
orphanage	අනාථාගාරය
needy	අවශ්‍ය
completing	සපුරාලීම
clerk	ලිපිකරු
nonavailability	නොමැති
firm	දැඩි
reaching	පැමිණීම
endemic	ආවේණික
foods	ආහාර
obstacles	බාධා
computed	පරිගණකගත
agree	එකඟ
fresh	නැවුම්
shifting	මාරුවීම
registration	ලියාපදිංචිය
terrorism	ත්‍රස්තවාදය
cab	කැබ් 
estimation	තක්සේරුව
erected	සෘජු
misplaced	නැතිවීම
incentives	දිරිගැන්වීම
recognize	හඳුනාගැනීම
intends	අදහස්
clarke	ලිපිකරු
largely	වැඩිපුර 
encyclopedia	විශ්වකෝෂය
organize	සංවිධානය
diverse	විවිධ
tabled	වගුගත
approve	අනුමත
calculation	ගණනය 
sewing	මැසීම
strength	ශක්තිය
visas	වීසා
reflects	පිළිබිඹු
threeday	තෙදින
creditor	ණයකරු
bay	බොක්ක
inaugural	ආරම්භක
capability	හැකියාව
combination	එකතුව
white	සුදු
parking	නැවතුම්
nationalities	ජාතීන්
ago	පෙර
attendance	පැමිණීම
context	අන්තර්ගතය
celebrate	සැමරීම
concerning	අදාළව
largest	විශාලතම
keeper	භාරකරු
theater	රඟහල
chairperson	සභාපතිතුමා
oneday	එක්දින
revenues	ආදායම
dramas	නාට්‍ය
injuries	තුවාල
harbour	වරාය
acreage	අක්කර 
physiotherapy	භෞතචිකිත්සාව
invest	ආයෝජනය 
devices	උපකරණ
patients	රෝගීන්
displaying	ප්‍රචාරණය 
remarkable	විශිෂ්ට
military	හමුදා
poles	කණු
spatial	අවකාශීය
qualifying	යෝග්‍යතාව
recent	මෑත
eco	පාරිසරික
boxes	පෙට්ටි
multiple	බහු
messages	පණිවිඩ
thereof	එයින්
coast	වෙරළ
rare	දුර්ලභ
finally	අවසානයේ
wells	ළිං
exist	සිටිනවා
sulphate	සල්ෆේට්
offer	ප්‍රදානය
proportion	කොටස
consistent	අනුරූප
charter	ප්‍රකාශපත
mechanisms	ක්‍රමවේද
temporarily	තාවකාලිකව
networks	ජාල	
additions	එකතුවීම්
doctors	වෛද්‍යවරුන්
tenders	ටෙන්ඩර්
evident	පැහැදිලි
causes	හේතු
disadvantaged	අයහපත් 
comprised	අඩංගු 
investigating	විමර්ශනය 
referring	සම්බන්ධයෙන්
reimbursed	පියවම
consultations	උපදෙස්
lotteries	ලොතරැයි
researches	පර්යේෂණ
government	ආණ්ඩුව 
telecasting	විකාශනය
lane	මාවත
interpreters	අර්ථකථකයා
rather	වඩා
cohesion	ඒකාබද්ධතාව
mail	තැපෑල
cells	කුටි
environmental	පාරිසරික
credits	ණය
mind	මනස
longer	දිග
supervised	පරිපාලිත
constable	කොස්තාපල්
retire	විශ්‍රාම 
big	ලොකු
phases	අදියර
gardiner	ගාර්ඩිනර්
deprived	තොර 
cultured	ශිලාචාර
nopay	නොගෙවන
calculate	ගණනය 
bearing	දැරීම
married	විවාහවූ
inhouse	නේවාසික 
clinical	සායනික
psychological	මානසික
paye	ගෙවීම
premium	වැඩිම
barriers	බාධක
dollars	ඩොලර්
ambassador	තානාපති
replace	ප්‍රතිස්ථාපනය
exam	විභාගය
linked	සම්බන්ධිත
latest	නවතම
excellent	විශිෂ්ට
impacts	බලපෑම්
explore	ගවේශණය 
foster	පෝෂණය 
craft	කර්මාන්තය 
grand	උසස්
superintendents	පරීක්ෂකවරුන්
sovereign	ස්වාධීන
closely	සමීපව
reading	කියවීම
irrespective	නොසලකා
notices	දැන්වීම්
magazines	සඟරා
late	ප්‍රමාද
accompanying	සමග 
attorneyatlaw	නීතිඥ
preservation	සංරක්ෂණය
lagoon	කලපුව
causing	හේතුවෙන්
designated	නියමිත
matches	තරග
tailoring	මැහුම්
investigate	විමර්ශනය 
contracted	ගිවිසුම්ගත
brief	කෙටි
appellate	අභියාචනය
enrichment	පේෂණය
maritime	සමුද්‍රීය
reconcile	ප්‍රතිසන්ධාන
cancelled	අවලංගු 
serious	බරපතල
significance	වැදගත්කම 
gravel	බොරලු
games	ක්‍රීඩා
nonresidential	අනේවාසික
museums	කෞතුකාගාර
refund	පියවීම
owns	අයිතිය
arrived	පැමිණි
bound	බැඳුණු
installment	වාරික
contest	තරගය
rupee	රුපියල්
colleges	පාසල්
ease	පහසුව   
outcomes	ප්‍රතිඵල
recognizing	හඳුනාගැනීම
degrees	අංශක
torrington	ටොරින්ටන්
chairs	ප්‍රධානීන්
overdrafts	අයිරාව
ex	පෙර 
limestone	හුණුගල්
duplicate	පිටපත
kalutura	කළුතර
huge	විශාල
nor	නැත
diversification	විවිධාංගීකරණය
dependents	යැපෙන්නන්
economical	ආර්ථික
instruction	උපදෙස් 
immensely	වැඩිපුර 
clusters	පොකුරු 
cleaner	ශෝධකයා
tool	උපකරණය
administered	පරිපාලිත 
textiles	රෙදි
gamma	ගැමා 
deliver	බෙදාහැරීම
turn	හැරීම
regularize	ක්‍රමානුකූල
developments	දියුණුවීම්
incorrect	වැරදි
gifts	තෑගි
inches	අඟල්
custody	භාරය
vehicular	ප්‍රවාහන
disclose	හෙළිදරවු
notify	දැනුම්වත්
suggestions	යෝජනා
consistently	අඛණ්ඩව
linking	සම්බන්ධිත
numbering	අංකිත
trainee	පුහුණුකරු
ordinances	ආඥාපනත
formation	පිහිටුවීම
congress	සම්මේලනය
ensures	සහතික
businesses	ව්‍යාපාර
shifts	මාරුකිරීම්
harvest	අස්වැන්න
remove	ඉවත්
franchise	ඡන්දහිමි
contributors	දායකයන්
allocating	වෙන්කිරීම්
greatly	බොහෝ
anicut	අමුණ
organic	කාබනික
hired	කුලියට
logic	තර්කන
removing	ඉවත්
computerization	පරිගණකගත
advisor	උපදේශක
equally	සමානව
directory	නාමාවලිය
pre	පෙර
joining	එකතුව
prepares	සූදානම්
disparities	විෂමතා
dollar	ඩොලර්
venue	ස්ථානය
additionally	අමතරව
annexed	අමුණා
govern	පාලනය
pest	පළිබෝධ
marks	සලකුණු
visiting	සංචාරක
rains	වැසි
register	ලේඛනගත
conversions	පරිවර්තන
kilograms	කිලෝග්‍රෑම්
topic	මාතෘකාව
botany	උද්භිද
astronomy	තාරකා
extensive	පුළුල්
takes	ගනී
empowered	බලයලත්
saved	සුරක්ෂිත
changings	වෙනස්වීම්
evidences	සාක්ෂි
printouts	මුද්‍රණ
sensitive	සංවේදී
inspect	පරීක්ෂාව
translations	පරිවර්තන
measurable	මැනිය
preserve	සංරක්ෂණය
partial	අර්ධ
electorate	මැතිවරණ
brass	පිත්තල
flowers	මල්
numerous	බොහෝ
inputs	යෙදවුම්
manufacturers	නිෂ්පාදකයන්
negotiation	සාකච්ඡා
trailers	ට්‍රේලර්  
attractive	ආකර්ෂණීය
connecting	සම්බන්ධිත
vacation	නිවාඩු
entitlement	හිමිකම්
volunteers	ස්වේච්ඡා
delegations	නියෝජිත
acre	අක්කර
ornamental	විසිතුරු
adding	එකතුවක්
yields	අස්වැන්න
propagation	ප්‍රචාරණය
mixed	මිශ්‍ර
purification	පවිත්‍ර
artistes	කලාකරුවන්
referendum	ජනමත
coach	පුහුණුකරු
stands	නැගීම
subsection	උපවගන්තිය
treaty	ගිවිසුම
expeditiously	ඉක්මනින්
order	නියෝග
exemption	නිදහස්
optical	ප‍්‍රකාශන
replacing	ප්‍රතිස්ථාපනය
accommodate	නවාතැන්
handicapped	ආබාධිත
dependants	යැපෙන්නන්
neglected	නොසලකා
overview	විශ්ලේෂණය
route	මාර්ගය
quantitative	ප්‍රමාණාත්මක
starting	ආරම්භය
leaves	කොළ
plates	පිඟන්
phones	දුරකථන
airtime	ගුවන්කාලය
retain	රඳවා
shared	බෙදා
assists	සහාය
accomplished	ඉටුකර
fungal	දිලීර
speedy	වේගවත්
performs	ඉටුකරනු
lanes	මංතීරු
increases	වැඩිවීම
desired	කැමති
bamboo	උණ
licences	බලපත්‍ර
qualification	සුදුසුකම්
essays	රචනා
enforce	බලාත්මක
filing	ගොනු
encourage	දිරිමත්
teams	කණ්ඩායම්
began	ආරම්භක
floors	මහල්
dealt	ගනුදෙනු
hectare	හෙක්ටයාර්
servicing	සේවා
tabulation	වගුගත
prefabricated	පෙරසවි
adults	වැඩිහිටියන්
element	අංගයක්
disable	අක්‍රිය
bylaw	අතුරුනීතිය
recurring	පුනරාවර්තන
men	පිරිමි
ascertain	තහවුරු
auction	වෙන්දේසිය
wishes	අපේක්ෂා
justices	විනිසුරුවන්
sworn	දිවුරුම්
offence	වරදක්
declare	ප්‍රකාශයට
severe	දැඩි
concert	ප්‍රසංගය
moving	විචලනය
pumps	පොම්ප
kits	කට්ටල
batteries	බැටරි
interior	අභ්‍යන්තර
receives	ලැබේ	
secured	සුරක්ෂිත		
liberation	විමුක්ති
aforementioned	ඉහතින්
exceeds	ඉක්මවා
wheelers	රෝද
cycles	චක්‍රීය
forests	වනාන්තර		
uninterrupted	නිරතුරුව	
promising	පොරොන්දු
observing	නිරීක්ෂණය
entrepreneur	ව්‍යවසායක	
inside	තුල	
resilience	ඔරොත්තු		
adjust	සකස්
mention	සඳහන්
weaknesses	දුර්වලතා	
venture	ව්‍යවසාය
stabilize	ස්ථාවර
accomplish	ඉටුකර	
cut	කපා
specimens	නිදර්ශක
satisfy	තෘප්තිමත්
finished	අවසන්
staffs	කාර්ය	
experiments	අත්හදා	
cashew	කජු
literary	ශාස්ත්‍රීය
clerical	ලිපිකරු
leaflets	පත්‍රිකා
qualitative	ගුණාත්මක
deployment	යෙදවීම
hotels	හෝටල්
collects	එකතුව
compost	කොම්පෝස්ට්
payment	ගෙවීම
renovating	ප්‍රතිසංස්කරණය
coins	කාසි
propaganda	ප්‍රචාරය
system	පද්ධතිය
painting	තීන්ත
attract	ආකර්ෂණය
regards	ගෞරවය
sectorial	ආංශික
debit	හර
emergencies	හදිසි
freight	ප්‍රවාහනය
periodically	වරින්වර
putting	දැමීම
hands	අත්
inspected	පරීක්ෂාවේ
prohibition	තහනම
blood	ලේ
athletic	මලල
convenient	පහසු
govern	පාලනය
calculations	ගණනය
thoroughfares	මාර්ග
disclosure	හෙළිදරව්
projects	ව්‍යාපෘති
photos	ඡායාරූප
noteworthy	සැලකිය
interdiction	තහනම්
lightning	අකුණු
telephones	දුරකථන
ecological	පාරිසරික
meteorological	කාලගුණ
prominent	ප්‍රමුඛ
translating	පරිවර්තනය
accelerate	වේගවත්
topic	මාතෘකා
stamps	මුද්දර
extensions	දිගු
educated	උගත්
simple	සරල
beneficial	ප්‍රයෝජනවත්
references	යොමු
approve	අනුමත
fixing	සවිකිරීම්
tiles	ටයිල්
render	ඉදිරිපත්
iron	යකඩ
judgement	විනිශ්චය
impart	බෙදාගැනීම
relates	සම්බන්ධිත
profession	වෘත්තිය
spectral	වර්ණාවලි
aid	ආධාර
fullest	සම්පූර්ණ
packing	ඇසුරුම්
impart	බෙදා
tenure	දරා
discrepancies	විෂමතා
offers	ඉදිරිපත්
exempted	නිදහස්
metres	මීටර්
financially	මූල්‍යමය
competent	දක්ෂ
accredited	ප්‍රතීතක
fairs	පොළවල්
gigawatt	ගිගාවොට්
debits	හර
limitations	සීමාවන්
images	රූප
unused	අලුත්
interchange	හුවමාරුව
option		විකල්පයක්
symposium	සම්මන්ත්රණය
ayurveda	ආයුර්වේද
bundles	මිටි
replaced	වෙනුවට
aerial		ගුවන්
meets		හමුවේ
solving	විසඳීම
learners	ඉගෙන
populations	ජනගහනය
ranged		පරාසයක
narcotics	මත්ද්රව්ය
documented	ලේඛනගත
brick		ගඩොල්
width		පළල
speed		වේගය
crafts		අත්කම්
survival	පැවැත්ම
allow		ඉඩ
sportswomen	ක්රීඩිකාවන්
columns	තීරු
lorries	ලොරි
examining	පරීක්ෂා
understand	අවබෝධ
dispose	බැහැර
mine		මගේ
litigation	නඩු
guided		උපදේශක
weak		දුර්වල
withdrawn	ඉවත්
narcotic	මත්ද්රව්ය
mineral	ඛනිජ
just		හුදෙක්
garments	ඇඟලුම්
tare		තාර